# Class / Structs
BQ40Z80	KEYWORD1
CUVConfig	KEYWORD1
COVConfig	KEYWORD1
OCCConfig	KEYWORD1
OCDConfig	KEYWORD1
AFEConfig	KEYWORD1
TempConfig	KEYWORD1
SleepConfig	KEYWORD1
BalancingConfig	KEYWORD1
LifetimeDataBlock1	KEYWORD1
LifetimeDataBlock2	KEYWORD1

# Methods
begin	KEYWORD2
setDebug	KEYWORD2
getVoltage	KEYWORD2
getCurrent	KEYWORD2
getAvgCurrent	KEYWORD2
getTemperature	KEYWORD2
getSOC	KEYWORD2
getRemCapacity	KEYWORD2
getFullCapacity	KEYWORD2
getCycleCount	KEYWORD2
getCellVoltage	KEYWORD2
getDeviceType	KEYWORD2
getChemID	KEYWORD2
getAllCellVoltages	KEYWORD2
getGaugingStatus	KEYWORD2
getChargingStatus	KEYWORD2
getOperationStatus	KEYWORD2
getSafetyStatus	KEYWORD2
getSafetyAlerts	KEYWORD2
getPFStatus	KEYWORD2
decodeSafetyStatus	KEYWORD2
resetProtectionStatus	KEYWORD2
isSealed	KEYWORD2
getLifetimeDataBlock1	KEYWORD2
getLifetimeDataBlock2	KEYWORD2
resetLifetimeData	KEYWORD2
unseal	KEYWORD2
enterFullAccess	KEYWORD2
seal	KEYWORD2
beginConfig	KEYWORD2
endConfig	KEYWORD2
setDesignCapacity	KEYWORD2
setCellCount	KEYWORD2
setThermistorConfig	KEYWORD2
enableGauging	KEYWORD2
setThermistorCoefficients	KEYWORD2
setUpdateStatus	KEYWORD2
setTermVoltage	KEYWORD2
setChargeTermTaper	KEYWORD2
setLoadMode	KEYWORD2
setPinConfiguration	KEYWORD2
setLEDConfiguration	KEYWORD2
setSleepConfig	KEYWORD2
setNonRemovable	KEYWORD2
enableAutoFET	KEYWORD2
setCHGFETToggle	KEYWORD2
setDSGFETToggle	KEYWORD2
resetDevice	KEYWORD2
setCUVConfig	KEYWORD2
setCOVConfig	KEYWORD2
setOCC1Config	KEYWORD2
setOCD1Config	KEYWORD2
setBalancingConfig	KEYWORD2
setAOLDConfig	KEYWORD2
setASCCConfig	KEYWORD2
setASCD1Config	KEYWORD2
setASCD2Config	KEYWORD2
setOTCConfig	KEYWORD2
setOTDConfig	KEYWORD2
setUTCConfig	KEYWORD2
setUTDConfig	KEYWORD2
readByte	KEYWORD2
readWord	KEYWORD2
writeWord	KEYWORD2
readMACBlock	KEYWORD2
writeDFBlock	KEYWORD2
writeDFWord	KEYWORD2
readDFWord	KEYWORD2
writeDFByte	KEYWORD2